0	0	0	512	672	4	0
01	0	0	256	336	4	0
011	0	0	128	168	0	0
012	128	0	128	168	0	0
013	0	168	128	168	0	1	24
014	128	168	128	168	0	1	0
02	256	0	256	336	4	0
021	256	0	128	168	0	0
022	384	0	128	168	0	0
023	256	168	128	168	0	0
024	384	168	128	168	0	1	20
03	0	336	256	336	4	0
031	0	336	128	168	0	6	4	5	6	10	22	23
032	128	336	128	168	0	4	5	7	21	26
033	0	504	128	168	0	3	1	8	9
034	128	504	128	168	0	3	2	8	9
04	256	336	256	336	4	0
041	256	336	128	168	0	3	15	16	17
042	384	336	128	168	0	3	16	18	19
043	256	504	128	168	0	2	11	12
044	384	504	128	168	0	3	12	13	14
